1111111
100000011111
1000000000111111111111111
1111111111111100000000001          111111111
11 11 1 1 1   111111111111111       10000001      1
               111111111             10000001    101
                 111111              1000011     11
                  1111               1111W1
                                         1
