NO ../textures/north

SO ../textures/south

WE ../textures/west

EA ../textures/east

F 255,10,0

C 225,30,0

1111111
100N001
1111111