NO ../textures/north

SO ../textures/south

WE ../textures/west

EA ../textures/east

F 255,10,0

C 225,30,0

11111111111111
10000000000001
10000000000001
10000000000001
100000N0000001
10000000000001
10000000000001
11111111111111
11111111111111