111111
100000011111
10000N0000001111111111
1111111111111100000000001
             111111111 
  