111111
100000011111
10000N000000111111111111
1111111111111100000000001           11111111
              11111111111            10000001
               111111111             10000001
                 111111              10000001
                  1111               11111111
                   11
                   1
                   1
                   1
