NO textures/north.xpm

SO textures/south.xpm

WE textures/west.xpm

EA textures/east.xpm

F 255,192,203



     
  
C 225,255,0

11111111111111
10000000000001
10001111100001
100000N0000001
10000000000001
1111111111111
