NO ./path_to_the_north_texture

SO ./path_to_the_south_texture

WE ./path_to_the_west_texture

EA ./path_to_the_east_texture

F 220,100,0

C 225,30,0

1111111
10000011111
1000000000111111111111111
1111111111111100000000001   1111111111111111
11 11 1 1 1   111111111111111       10000001      1
               111111111             10000001    101
1                                11  1111111111111111
                                1   
                                1

								1
11111111111111111111111111111111W11111111
1                 111111        111   10011     
                  1111               1111
